assets/tilemaps/tilesets/tileset_campo.png
32 32

# caminhavel
*
1 1 1 1 0 1 0 0
1 1 1 1 0 1 0 0
1 1 1 1 1 1 0 0
1 1 1 1 1 0 0 0
1 1 1 1 1 1 1 1
1 1 1 1 1 1 1 1
1 1 1 1 1 1 1 1
1 1 1 1 1 1 1 1
1 1 1 1 1 1 1 1
1 0 0 1 1 0 0 1

# nivel
*
0 0 0 0 1 0 1 1
0 0 0 0 1 0 1 1
0 0 0 0 0 0 1 1
0 0 0 0 0 1 1 1
0 0 0 0 0 0 0 0
0 2 2 0 0 2 2 0
2 2 2 2 2 2 2 2
2 2 2 2 2 2 2 2
2 1 1 2 2 1 1 2
0 1 1 0 0 1 1 0

# custo adicional
*
0 0 0 0 0 0 0 0
0 0 0 0 0 0 0 0
0 0 0 0 0 0 0 0
0 0 0 0 0 0 0 0
0 0 0 0 0 0 0 0
0 0 0 0 0 0 0 0
0 0 0 0 0 0 0 0
0 0 0 0 0 0 0 0
0 0 0 0 0 0 0 0
0 0 0 0 0 0 0 0